R 1200 800

NO ./map_data/path_to_the_north_texture.xpm
SO ./map_data/path_to_the_south_texture.xpm
WE ./map_data/path_to_the_west_texture.xpm
EA ./map_data/path_to_the_east_texture.xpm
S ./map_data/path_to_the_sprite_texture.xpm
F 220,100,0
C 225,30,0


                  1
                110111
             1111101111
        11111111110111111111111111
        1000000000010000000000001
        1011000001010000000000001111111111111111
        1001000000000000000000001111
111111111011000S01110000000000000
111110000011000001110111111111111
     11110111111111011100000010001
111110001101010111000000100011111111
10000000100000001100000010001
11111111 1111111 111111111111111111111
              11 111111111
                 11111
                 1111
                 11
                 1