R 400 400

NO ./textures/north.xpm
SO ./textures/south.xpm
WE ./textures/west.xpm
EA ./textures/east.xpm
S ./textures/sprite_barrel.xpm
F 220,100,0
C 225,30,0

1111111111111111111111111111111111111111111111111111111111111111111111111111111111111111111111111111
1000000002000020002000000000002000000000020000000000000000000000200000000000000000000000000000202001
1020020000020000000000000000000000000000020000200200000000200000000000000200000000000000000000000001
1000022000020020000000002000000000000002000000000000000000000000000200000020000000000220002020000001
1200200000000020200200000000000000000000000202200000000000200200000000202020002000200000000002000001
1000200000000000000000000200200000000000000000000000200000000002000002000000000200002000000000000001
1000000000000000000000000000000002000000000000000000200022000000000000000000020200000000020200200201
1000000000000002000000000000202200000000002200002000000000000000200000000200000000000020000000000201
1000200000000002000000000000000020000000000000000000000002000000000000000000000000000000000000000001
1000000200000220000200000000000000000020000000000000000200000000020000000000020020000000002000000001
1000002002000000000000000000020000000000000000020000000000002000002020000000020000000002000200020001
1200000000000000020000002000200000000000220000002000002000020000000000000000002000000220000000200001
1000002000020000000022000000000020000000000000000000000000000000020002000200000000000000000000000001
1000000000000000000000002000002000000000000000002020000000000000000000000000000000000200000000002001
1000002002000000220200000002000000000000000000000000000020000000000200020000000000002020000200200001
1000200000000020000000020000000000000000000000200000000000000020020200000000020000200200200000002001
1000000000000002000000000000000200000000000000200000000000000002000020000000000000020000000002000001
1000000000000000000000000000022000000000000002000000020000000200000000020000000000002000000002000001
1000000000000000000000000000000000000000000020000000200000000000000000000220202000000000002000000001
1002002020002000200000000020000020000000000000000220000000000000200000002000000000000000000200000001
1020020002000000000000000000000000000000002000200000200000202000000000000000000002000200020000000001
1000020000000000002000000000000000020000000000002000000000000000000000000000000020000000002000000001
1002000202000000000000000000002020000000000020000000000020200000020000002020000000000000200000000001
1000020000000022000000200200022000200000000000000000220000000000000200000000000000000020000020000001
1000000000000200002200020000000020000200200000002000000000022020000000000000000002002000000000000001
1000020000000000020020000000002020000000200000000000000000200000000000000000020000000020000002000001
1000000020000000000000000000000000000000000000000000000000000000000000000000000002000002000000000001
1000000000000000000022000000000000000002000000002000020000000000000000000000020000000000002000000001
1000020000000000200000002200000000000000020020000200200000000200000000000000202200000000000000000001
1000000000000000000000220000000000020000000000000000000000002000002000000020000000000002000000000001
1000000000000000000200000020000000002000000000000000000000020200000000000000000000000000000000000201
1000000020000020200000000020000000002000020000000000000000000000000000020000000000000000000000000001
1000000200000000000200000000000002000000000000000000000000000000000000000000000022000002220002000201
1000000000000002000000000200202000000000000220000000000020000000000000000000000200000200000000000001
1000000000002000000002000020000000000000000002220002002000000000002000000000000000000000000000200001
1000000000200020000000202200020002000000000000000000000000000000000000000000000000000202000000000001
1000000000000200020000000000002020000000000000020002000000000000202000000200200000000000002000000001
1000000200020000002000202000020020000000000000000020000000000000000020020000020000000000000000020001
1000000000200020000200000000000000000000000000002000000000000000000000000000000000000200000020200201
1000000000000000000000000000002002000000000000000000000000000000000000000002000000000000200000000001
1000200000020000000200000002000000000200200000002000000000200002000000000000000000000000000022000001
1000000000020000000000002000000000020002000000000000000000000000000002200000000220000000000000000001
1020000000020020000200000000000000002200000000020202000000002000000000000002000000000002200000002021
1000000000000000000000022000000000000000000002000000020000200002000000000002000000000000000200000001
1000002000000002000020020020000000000220000000200200000000000000000000020000020020000000000000020001
1000000000200000000000000000000000000000000000000000020000000000000000000000000000000000000000000001
1000000000220000000200000000000000000002020000000200000000220202020000000000000000000000000000000001
1000000000000000000000000000200202002000002000202000000000200000000002000002000000000000002000000001
1002000000200000000000020000000200202000000000000000000000020000000020002000200000020022200000000001
1000000000000000002000000020000000000000200000000000000000000000000200000002000200000000000000000201
10000000000002000000000020000002202000000020000000N0000000000000000000000000200200000000002000000001
1000000000000000000002002000200000000000000000000200002000000020000000000000000000000000000000000001
1000000000000000200000000000000000000200000020200000000000000000000000200000002020000000000000000001
1002220000000200000000000000000000000000200000000000000020002000000000200222000020000000000000000001
1000200000000022000000000000002000000022000000000000200000020200000000000200000000000020000000000021
1000000000000000000000000000000020000000000000000000000000000000000020000020000000000000000000002001
1000000002002000000000000000000200000002000000000002002000000000000000002000200000002000020000200001
1000000002000000000000000000000000000000020200000000000000200000000200000000000000000000000020000001
1002000000000000000022000000202000000000020002000000000000000000000000000000200200000000000000000001
1002000000000000000000000000002200000000000000000000000002000000000200000000000000200002000000000001
1000200000000000000000000002000000000000200000000020000222000000002000002000000000000000000000000001
1022000000002022000000020000000000000000000200000200000002000000000000000000000000000002000000000001
1000020002000200020000000202020000000000000200200000000000002002000000020200000200000000000000000001
1000000000000000000000000022000000000000000000000000000000000000000002000000000000000000200002002001
1000200002000000000000000000000000000000000000000000000000000000000000000000200000000000020000000201
1000000020000000000000200000002000002000200000020000000000000200000200000000020000000020000000002001
1200220002000000002200000000200220000020220000200000020000200000000000000000000000000020000002000001
1000000202000200000000020000220002020000000000000000002020000000000000000000000000000000000000020001
1000000000000000000022000000000002000000200000000200000000000002000000020220000002000000200000000001
1000020000200002002000000000200000020000200000000000000022000200000000000000002020200020000000000001
1000002002000002000000000002000000000000000000000000000000020000000000000000000000000000020000000001
1000000000020200000000000000000000000000000020000000002000200000000000000200200000000000020000000001
1000000000000000002020200020020000000020200000000200000200200020020000000000000000200220000000000001
1200002000020000000000000000020020200200000000000000000000202020200002000000000000002000000000000001
1020200200022000000000000020000000000000000200000000000000000000000000000000000000200000022000000001
1000000000000002000002000202000200000200000000000000020020020020000000000000202000000000000000000001
1000000000000000000000020000000020000000020002000000000000000000000000020000000000000000200000020021
1000000020000200000000000000000000000000000000000200000000202020200000020000000020020200000000000021
1000000000000000202000000000000200000020000200000200000002000020000000200000000000000200000002000001
1000000000000000000000000000000000220000000000000000000000020000000020000000000000000000000000020001
1002000020000000000002000020000020000000000000002000000020000000000000200000000020000000000000020201
1200020000000000000000002000020000200000000000000002000000000000000000000000000000200022000000000001
1000000000000000000200000220000200002000000000000000002000000022000000000000000000000000000000000001
1000000000000000000000000000000000020002000000000000000000000200000000000002000002000000200020000001
1000000000200000000200002020000000000000000002000200000000000000000200000020020000200000200020002001
1000000000000000002000000002000000000000200000020000000000020000000020000000000000200020020020000001
1000000002000000000000000020000000000000200000000000200000000000000002000200200020000020022020000001
1020000002000000000000202000000000000000000000000000000000200000002000000000000000000000000000000001
1000200000000200000020000000002000000000000020000220000200000000000000000000000000000000000000000021
1000000020200000000000200020000000000000000002000000000000002000000000002000200000000002000020000001
1002022220000000000020020000000000000200000000002000000000000000000000000000000020020000000000200001
1000000000002000000002000000000000002220000000000020002200000000200000000200020002000000200200020001
1000002000020000000022000000200000200000000000002000020200000000000000000000020000000020000002002001
1020000000000000000002000200000000000000000200222000000000000020000020000000200000000000000000000201
1000000000000002200000000000000000000000000000000000000000000000000000000000200000000000000000000001
1200000000000000000000000000000000000220000000000000000020000000000002000000000000000002000000000001
1000020000000200200000000000000002000000000000000200000000000000000200000000000000000002000002000001
1000000000020000000000000000000002000000000002000000000000000000000000000020000000000000000000000001
1020000000000000000000000000000020000000000000000000000000002000002202002000000000000000000000002001
1111111111111111111111111111111111111111111111111111111111111111111111111111111111111111111111111111