R 1200 650

NO ./textures/north.xpm
SO ./textures/south.xpm
WE ./textures/west.xpm
EA ./textures/east.xpm
S ./textures/pillar.xpm
F 220,100,0
C 225,30,0

1111111111111111111111111
1000000000110000000000001
1011000001110000020000001
1001000000000000000000001
1111111111111110000111111
1111111111111110000111111
1000000000110000000000001
10110000011100000N0000001
1001000000000000000000001
1111111111111111000011111
1111111111111111000011111
1000000000110000000000001
1011000001110000000000001
1001000000000000000000001
1111111011111111111111111
1111111011111111111111111
1000000000110000000000001
1011000001110000000000001
1001000000000000000000001
1111111111111111111111111
