R 1200 800

NO ./map_data/path_to_the_north_texture.xpm
SO ./map_data/path_to_the_south_texture.xpm
WE ./map_data/path_to_the_west_texture.xpm
EA ./map_data/path_to_the_east_texture.xpm
S ./map_data/path_to_the_sprite_texture.xpm
F 220,100,0
C 225,30,0

1111111111111111111111111
1000000000110000000000001
1011000001110000000000001
1001000000000000000000001
1111111111111110111111111
1111111111111110111111111
1000000000110000000000001
10110000011100000N0000001
1001000000000000000000001
1111111111111111011111111
1111111111111111011111111
1000000000110000000000001
1011000001110000000000001
1001000000000000000000001
1111111011111111111111111
1111111011111111111111111
1000000000110000000000001
1011000001110000000000001
1001000000000000000000001
1111111111111111111111111
