R 1200 650

NO ./textures/north.xpm
SO ./textures/south.xpm
WE ./textures/west.xpm
EA ./textures/east.xpm
S ./textures/sprite_barrel.xpm
F 220,100,0
C 225,30,0

1111111111111111111111111
1202020202020020202020201
1020202020200202020202021
1202020202020020202020201
1020202020200202020202021
1202020202020020202020201
1020202020200202020202021
1202020202020020202020201
1020202020200202020202021
100000000000N000000000001
1111111111111111111111111