R 1920 1080
NO ./map_data/path_to_the_north_texture.xpm
SO ./map_data/path_to_the_south_texture.xpm
WE ./map_data/path_to_the_west_texture.xpm
EA ./map_data/path_to_the_east_texture.xpm
S ./map_data/path_to_the_sprite_texture.xpm
F 220,100,0
C 225,30,0

111111111111111111111111111110
100000000000000000000000000001
100000000000000000000000000001
100000000000000000000000000001
100000000000000000000000000001
100000000000000N00000000000001
100000000000000000000000000001
100000000000000000000000000001
100000000000000000000000000001
111111111111111111111111111111