R 1200 800

NO ./textures/eagle.xpm
SO ./textures/wood.xpm
WE ./textures/greystone.xpm
EA ./textures/mossy.xpm
S ./textures/sprite_barrel.xpm
F 4,100,0
C 0,30,100

1111111111111111111111111
1000000000110000000000001
1011000001110000200000001
1001000000000000000000001
1111111111111110020111111
1111111111111110000111111
1000000000110000020000001
1011000001110020000002001
1001000000000000002000001
1111111111111111000011111
1111111111111111000011111
1000000000110000200000001
1011000001110000000020001
1001000000000000000000201
1111111011110000000000001
11111110111100000N0000201
1000000000110020000000001
1011000001110000002000001
1001000000000000000000001
1111111111111111111111111