R 1200 800

NO ./textures/eagle.xpm
SO ./textures/wood.xpm
WE ./textures/greystone.xpm
EA ./textures/mossy.xpm
S ./textures/sprite_barrel.xpm
F 220,100,0
C 225,30,0

1111111111111111111111111
1000000002000100000000001
1000000000020111110111111
1000000200000000000000001
100020000000N000002000001
1111100200000000000000001
1020111000020000000002001
1000000000000000002000001
1111111111111111111111111