R 400 400

NO ./textures/north.xpm
SO ./textures/south.xpm
WE ./textures/west.xpm
EA ./textures/east.xpm
S ./textures/sprite_barrel.xpm
F 220,100,0
C 225,30,0

1111111111111111111111111111111111111111111111111111111111111111111111111111111111111111111111111111
1000000000000000000000200000000000000000200000000000000000000000000200000000000000000000000000000001
1002000000000000000000000000000000000000000000000000000000000000000000000000000000000000000000000001
1000000000020000000000000000000000000000000000000000000000000000000000000000000000000000000000000001
1000000000000000000000000000000000000000000000000000000002000000000000000000000000000000000000000001
1000000000000000002000000000020000000000000000000000020000000020000000000000020000000000000000000001
1000000000000000002000000000000000000000000000000200000200200000000000000000000000000000000000000001
1020000000002000000000000000000000000000002000000000000000000000000002000000000200000000000200000001
1000000000000000000000000000000000000000000000000000000000000002000000000000000000002000000000000001
1000000000200000000000000000000000000000000000000000000202000000000000000000000000000000000000000001
1000000000000000000000000000000000000000000000000000002000000200000000000000000000002000000000000001
1000000000200000000000000000000000000000000022000000000000000000000000000000000000000000000000000001
1000000000000000000000002000000020000020000000000000000002000002000020000000000000000000000000000001
1000000000000000000000000000000000002000000000000000000002000020000000000020000000000020000002000001
1000000000002000000000000002000000000000000000000000000000020002000000000200000000000000000000000001
1000200000000000000000000000000000220000000000000000000000000000000000000000020000000000000000000001
1000000020000000000000000000000000000000000000220000000000000000000000000000002000200000000000000001
1000000000000000000000000000000000000000000000200000000000000020000000000000000000000000000000002001
1000000000000000020002000000000000000000000000000000000000000000000000000000000000020000000000020001
1000020000000000000000000000000002000000000000000020000002200002000020000000000000002000000200000001
1000000000000000000000000000000000000000200000000000000000000020000000000020020000000000000000000001
1000000000000020000000020200000000200000000000000000000000000002020000000000002000000000000000000001
1000200000000020000000000000000000000000020000000000000000000000000000000000000000000000000000000001
1000000000000000000200000200000000000000000000002000020000000000000000000000000000000000000000000001
1000000000000000000000000000000000200000000000000000000000000000000000000000200000000000000000000001
1000000000000002000000000000000000000000000000000000000000000000000000000000000000000000000000000001
1000000000000000020000002000000000000002000000000000000000000000000000000002000000000000000000000001
1000000000000000000000000000000000000222000000000020020000000000000200000000000020020002200000022001
1000000200000200000000000000000000000000000000000000000200000000000000000000000000000000000000000001
1000000000000000000000000000000000000000000000000000000000000020000000000000000000000000000000020001
1200000200000000000000000000000000000000000000000002000020000000000000000000000000000000000000000201
1000000002000000000002000000000000000002000002000000000000000000000000000020020002000000000000002001
1000000020000000000000000000000000000200000000000000000000000000000000002000000000000000000000200201
1000000000000000000000000000000000000000000000000000000000000000000000020002000000000000000000000001
1000220000000000000000000002000000000000000200000000000000000000000000000000000000000000000000000001
1000000000200000000002000000000000000000000000000000000200000000000000000000000000000000000000000001
1000000000000002000200000000000002020000000000002020000000200000000000000000000000000000000000000001
1000000000000000000000000000000000000000000000000000000000000000002000000000000000000000020000020001
1000000000000000000000020000000000000000000000000000020000000000000000000000000000020000000200000001
1000000000000000000200020000200000000000000000000000020000000000020000000000000000000000000000000001
1000000000000000000000000020000000000000000000002000000000000000000000000000000000002000000000000001
1000020000000000000000000020002000000000000020000000000000000000000000000200000000000000000000000001
1000000000000000000000000000000002000000000020000000000000000000000000000000002000000000000000000001
1000020000002000000000000000000000000000000000000000020000000000000000000002000000000200000000002001
1000000000000000200000020000000000000000000000000000000000000000000000000000000000000000000000000001
1000000000000000000000000000000000000000000000000000022000000000000000000000200000000000200000000201
1000000000000000000000000000220002000000000000000000000000000000000000000000000000002000000200000001
1000000020002000000000000000200002000000000000000000000000000000000000000000000000000000000000000001
1000000000000000000000000000000000000000000000000000000000000000000000000000000000020000000000000001
1000022000000000000000000000000000000000000000000000000000000000000000002000000000000000020000000001
1000000000200002000000000000000000000000000000000200000000000000200000200000020000020000000000000001
1000000000000000000000000000000000000000000000000000000000000002000000002000000000000000002000000001
1200000000000000000000000000000002000000020000000000000000000020000000000000000000000000000000000001
1000000000200000000000002000000000000000000000000000000000200000000000000000000000000000000000002201
1000000000000000000000000000000000000200020000000000000000000000002202002000000200000000000000000001
1020000000000000000000000002000000000000000000000000002000000000000000000000000200000000020000000001
1000000002000000000000000000000000002002000000000000000000000000000000000002000000000000000200200201
1000000000020020000000000002000000000000020000000000000000000202000000000000000000200000000000002001
1000002020000000000000000000000000000000000000000020000000000000000000000000200000000000000000000001
1000000000000002000000000000000000000000000020000000000000000200002002000000000000000000000000000021
1000000000000000000000000000000000000000000000000000020000000000000000000000000000000000000000000001
1000020000002000000000000000000020000002000000000000000000000020000000000000000000000000000000000201
1000000020000000000000000000000020000020000000000000000000200000000000000000000000000000000000000001
1200000000002000200002000002002000000000000000020000000000000000000000000000000000020002000000000001
1000000000000000200200000000000000000000000000000000000000000000000000002020000000020000000002002001
1002000000000000000000000000000000000000000000000020000000000000000000000000000000000000222000000001
1000020000000000000022000000000000000000000000002000000000000000000000000000000000000000000000000001
1000000000000000000000000200000000000000000000000000000000000000000000000020000000000000002000000001
1002000000000200000000000000000000000000000000000000000000000000000020000000000002020000000000002001
1000000000000000000000000000202000000000000200000000000000000000000000000000000000000000000000000001
1000000000000000000002000000000000000000200000000000000000000000000000000000000000000000000000000201
1000000000000000000000000002020200000000000000000000000000000000000000000000000002000000000000000221
1002002000002000000000000000220002000020000000000000000020000000200000000000000200000000000000000001
1000000002000000000000200000002000000000000000000000000000000000000000000000000200000020000000000001
1000000000000000000000000000000000000000000000000000000000000000000000000000000000000000000000000001
1000000000000000000200000000000000000000020000000000000000000000020000000200020000000000000000002201
1000200000000000000000000000200000000000000000000000000000000000000000000002000000000000000002200001
1000020000002200000000000000000002000000000000000000200000000000000000000000200020000000000000000201
1000000000000000000000000000000000000000000000000000000000000002000000000200000020020000000000000001
1000000000000000000000000000000000000000000002000000200000000000000002000000000000000000000000000021
1002000220000000000000000000000000000000000000000000000000000000000000000000002000000000000002000001
1000000000000000000000000000000000000000000200000000000000000220000000020000002000000000000000000001
1000000000000000000000000000000000000000000000000000000000000000000000000000000000000200000000000001
1000000000000000020000000000000020000000000000000000000000000000000000000000000000000000000000000021
1000000000000200000000000000000000000000022000000000000000000000000000000000000000000000000000000001
1000000000000000000000000000000000000000020000000000000000000000002000000000000000000000000000000001
1000000000000200200020000000000002000000000020000000000000000000002000000000002000000000000000000021
1000200200000000000000000000000000000000000002000000000000000020000000000000000000000000000020000001
1000000000000000000002000000002000000000000000200000000000200000000000000000000022000000000000000001
1000000000020000000000000000000000000000000000000020000000000000000000000000000002000000000000000001
1000000000000020000002000000000000000000000000000000000000000000000000000000000000000200000000000001
1002200000000000000000000000000000000000000002000000000000000000020000000000000000000000000000000001
1000000000000000000000000000000000000000000000000000000000000000000020000000000000000020000020000001
1000200000000000000000000000002000000020020020000000000000000000000000000000000000000000000000000001
1000000000000020000000000000000000000000000000000000000000200000020000000000000000000000000000000001
1000000000002022000000000000002200000000000000000000000000000000000000000000000000000002000000020001
1000000000000000000000000000020200000000200000000000000000000000000000000000020000000000000000000021
1000000000000000000000000000000000000000000000000000000000000000000000000000020000000000000200000001
1000000000000000000002200000000000000000000000000000000000000000000000000000000000000200000000000001
1200000000000000000000000000000000000200000000000000000200000000000000000000000000000000000000000001
10000200000000000000000000000000000000000000000000N0000000000000000000020200000000000000000000000001
1000002000000000000000000000000020000000000000000020000000000000000000000000000000000200000200000001
1000200020200000000000000000000000000200000000000000000000000000000000000000020000000000000000000001
1000000000000220000200002000020000000000000000000000000020000000000000000000020002000000000000000001
1000002220000000000000000000000000000200000000002000000000000000000000000000000002000000000000000001
1000000000000000020000000000000000000000020000002000000000000000000000000200000000000000000000000001
1000000000000000000000020000002000000000000000000000020000000000000200000000000000000020000000000001
1000000000000000000000000000000200000020000000000000000000000000000000000000000000000000000000000001
1000000000002000000020000000000000000200000000000000000000000000000000000000000000200000000200000001
1000200000000200000020000022000000000000000000000000000000002200000000000000000002000000000000000001
1000000000000000000000000200000000000000000000000000002002000000000000000020000000000000000000000001
1000000000000000002000202000000000000000020200000000000000000000000000002000000000000000000000000001
1020000000000000000000200000000000000000000000000000000000000000000000200002000000000000000000000001
1000000000000000000020000200000000000000000000000000000000000000000000000000000000020000000220000001
1000200000000000002000000020000000000000000220000000000002200000000000000000000000000200000200000001
1000000000000000000000002000020000000200000000000000000000000000000000000002000020000000000000000001
1020000020000000020000000000000020000000000000000000000000000000000000000000000020000000000200000001
1000002000000000000000202000000200000000000000000000000000000000000000000000200200000000000000000201
1000000000000000000000000002000000000000000000000000002000200000000000002000000000000000000000000001
1000000000000000000000020002000200000000000000000000000000000000000000000000000000200000020000000001
1000000000000000000000000000000000000000000000000000000000000000000000000000000000000000000000000001
1000000000220000000000000000000000000000002000002020000000000000000000000002000000000000000000000001
1000000002000002000000000000000000000000000000002000020000000000000000000000000000000000000000000001
1000000000000000020000000000000000000000000020200000000000000000000002020000000000020000000000000001
1000000000200000000000000000000000000200000000000000000200000000000000000000000000000000000000000001
1000002000000000020020000000000000002000000000200000000000000002000000000200000200000000000000000201
1020000000000000000000222000000000000000000220000000000020000000000000000000020000000000000000000001
1020000002000000000000000000000000000000000000000000200000200000000000000000200000000000000000020001
1000000000000020000000000000000000000000000000020000000000000000000000000000000000000000200000002001
1000000000000000000000000002000000000000000020000000000000202000000000000000000000000000200000000001
1200002000000000020000000000200000000000000000200220000000000000000000020000000000000000000202000001
1000000000000000000000000000020020002000002000000000000000000000000000000000000000000000000000200001
1000000000000000200000000000000000000000000000000000000002000000000000000000000002000000000000002001
1000000000000000000000020000000000000000000000000000000000000000000000000000000020000000000000002001
1000000000000000000200000000000000000000002000000000000200000000000000000002000000000000000002000001
1000000000000000000000000002000000000000000000000020000000000000000000000000000000000000000000000001
1000020000000000000000000000002000000000000000000000200000000000000000000000000200000000000000000001
1000000000000000000000000000002020000000000000000000000000000000000020000000020000000000000000000001
1002000200000000000000000000000000000000000000000002000000020000002000000000000000020000200000000001
1200000000000000000000000000000000000000000000000000000000000000000000000000000000000000000000000001
1000000000000000000000000000000000000000000000002000000000000000000000000000000200000000000000000001
1000000000000000000000000000000000000000000000000000000000000000000000000200000000000000000000000001
1000000000000000000000000000200000000000020000000000000000000000000000000202000020000000000000200001
1000000000000000000000000000002000000000000000000000000000000000220000000000000000000000020000002001
1000000000020000002000000000000000000000000000000000000000000000000000000000000000000000000000000001
1000000000000000000000000002000002000000000000000000000020000000000000000000200000000000000000000001
1000000000000000000000000000000020000000000000000200000200200000000000020000000000000200000000000001
1000000002000000000000000000000000000000000000000000002000000000020000000000000000000000002000000001
1000000202000000000000000020000000000000000000000000000000000000000000002000000000000000000000000001
1000000002000020020000000200000002000000000000000000000000000000000000000000000000000000000000000001
1000000000000000000000000000000000000000000000000000000000200000000000000000002000000000000000000001
1000000000000200000000002000000000000000000000000000000200000200000020000000000000000000000000000001
1000000000000000000000000000000000000000000002000000000000000000000000000000000000000000000200000221
1000000000020020000000000000000000000000000000000000000000000000200000000200000000000200000000000001
1020000000000000000000000000000000000000000200000000000000000000020020020022000000000000000000000001
1000000000022002000000000000000000000000000000000000020200000000000000000000000000002000000000000001
1000000000000000000000000000020000000000000000200000000002000000000000000000200020002000200000000001
1000000020000000000200000000000000000000000000000000000000000000000002000000000000000000000000000001
1000000000020000000000000000000000000000000000000200000022000000000000000000000000000000000000000001
1000000000002000000000000000200000000000000000002000000000000000000000000000000000000220000000000001
1000000000000000000000020000020000000200000000000000000200000000000000000000000000000002000000000001
1000000000000000200000000000000000000200000000000000000000000000200000200200000000000000000000000001
1000000000000000000000002000000000000000000000000000000000000000000000000000000000000002000000000001
1002000000000000000000000000000000000000000000000000000000000000000000000000002000000000000000000201
1002002002000000000000000000000000000000000000020002000020000000000000000000000000000000000000000001
1000000000000000000000000000000000000000000000000000000000000000000000000200000200000000200000000001
1000000000000000000000000000000000000000000002000000200000000000000000000000000000000000000000000001
1000000000000000000000002000020000000000000000000000000000020000000000000000000000000000220000000001
1000000000000000000000000000002000000020002000000000000000000000000000000000000000000000000002000001
1000000000000200002200000000002000000000000000000000000000000000000000000000000000200002000000000001
1000000000000000000000020000000000000000000000200000000000000000000020000000000000000000000200000001
1000000000000200002020000000000000000000000000000000000020000000000200000000000000000000000000000001
1000000000000000000000022000000000000000000000000000000002000000000000000020000000200000000000200001
1000000000000000000020200000000000200020000000002200000000000000000000000200000000000000000000000001
1000000000000000000002002000000000000000000000000000000002000000000000000000000000000000000000000001
1000000002000000200020002002000200200200000000000000000200000000002000000000000000200000000000002001
1020000200000000000000000200000000000200000000000000000002000000000000000000000200200000000002000001
1000000000000000020000020000000000000000000000000000000000000020000000020000000000000000000000000001
1000000000000000000000000002020000000000000000000000000000000000000000000000000000000000000000000001
1200000000000000000000000000000200000000000200000000000000000000000020000000000000000000000000000001
1002000000000000000000000200000200002000000000000000000000000000000000000000000000000000000200200021
1000020000000200200000000000000000000002000000000000200000000000000000000000000000000000000000000001
1000000000200000000200000200000000000000000000000000000000000002000000200000000000000000020000000001
1000000000000000000000000000000000000020000000000000000020000000000000020000000000000000000000000001
1000000020000202020000000000000000000000000200000020000000000000000000000000000000000000000002000001
1000000000000002000002000000000000000000000000000000000000000000000000000000000000000002000000000001
1000000000000000000020000000000000002000200000000000000200000000000000000000000002000000000000000001
1000000000000000000020000000020000000000000000000000000000000002000000000000200000000000000000000001
1000000000000000000000000002000000000020000020000000200000000000000000000000000200000200000000020201
1000000000000000000000000000000000000000000000000000000000000000000000020000000000002000200000000001
1000000000000000000000000000000000000000000000000000000000000000000000000000000000000000000000000001
1202000200000020000020000000000002020000000000000000000000000000020000000000002000000000200002000001
1000000000002000000000000200000000000020000000000000000000000000000020000000000000000000000000000001
1000200000002000000000202200000000000200000000000000000000000000000000000000000000000000000000000001
1000000000000000000200000000000000000000000000000000000000000000000000000000000000000000200000000001
1000002000000000000000000000000200000000000000202000200000000000200000000000000000000000000200000001
1000000000000002000000002000000000000000000000000000000000000000000000000002000000000000000000000001
1000000000000000000000000000000000000020000000000000000020000000000000000000000000000000000000000001
1000000000000000000000000000000000000000000002000002000000000000000000000000000002000000020000000001
1000000000000000000000000000000000000000002000000000200000000000200000000000000000000000000000000001
1111111111111111111111111111111111111111111111111111111111111111111111111111111111111111111111111111